#######..#######
#..............#
#..............#
#..............#
#..............#
................
................
#..............#
#..............#
#..............#
#..............#
#######..#######

#######..#######
#..............#
#..............#
#..............#
#..|........|..#
...|........|...
...|........|...
#..|........|..#
#..............#
#..............#
#..............#
#######..#######

#######..#######
#..............#
#..............#
#........|.....#
#........|.....#
.........||.....
.....||.........
#.....|........#
#.....|........#
#..............#
#..............#
#######..#######

#######..#######
#|||........|||#
#||..........||#
#|............|#
#..............#
................
................
#..............#
#|............|#
#||..........||#
#|||........|||#
#######..#######

#######..#######
#..............#
#..............#
#..||||........#
#..|..|........#
...|..|.........
.........|..|...
#........|..|..#
#........||||..#
#..............#
#..............#
#######..#######

#######..#######
#..|........|..#
#..|........|..#
#..|........|..#
#..|........|..#
................
................
#..|........|..#
#..|........|..#
#..|........|..#
#..|........|..#
#######..#######

#######..#######
#..............#
#..............#
#..............#
#..|...||...|..#
................
................
#......||......#
#..............#
#...|......|...#
#...|......|...#
#######..#######

#######..#######
#..............#
#.....|..|.....#
#.....|..|..|..#
#..||||..||||..#
................
................
#..||||..||||..#
#..|..|..|.....#
#.....|..|.....#
#..............#
#######..#######

#######..#######
#..............#
#..............#
#..||......||..#
#..||......||..#
................
................
#..||......||..#
#..||......||..#
#..............#
#..............#
#######..#######

#######..#######
#..............#
#..............#
#..............#
#..............#
................
................
#..............#
#..............#
#..............#
#..............#
#######..#######

#######..#######
#..............#
#..............#
#..............#
#..............#
................
................
#..............#
#..............#
#..............#
#..............#
#######..#######



