#######..#######
#..............#
#..............#
#..............#
#..............#
................
................
#..............#
#..............#
#..............#
#..............#
#######..#######

#######..#######
#..............#
#..............#
#..............#
#..............#
................
................
#..............#
#..............#
#..............#
#..............#
#######..#######

#######..#######
#..............#
#.........|....#
#.........|||||#
#..............#
................
................
#..............#
#|||||.........#
#....|.........#
#..............#
#######..#######

#######..#######
#||||.......|||#
#....|.....|...#
#..............#
#..............#
................
................
#..............#
#..............#
#...|......|...#
#|||........|||#
#######..#######

#######..#######
#..............#
#..............#
#....|....|....#
#..............#
................
................
#..............#
#....|....|....#
#..............#
#..............#
#######..#######

#######..#######
#..............#
#..............#
#......||......#
#..............#
.....|....|.....
.....|....|.....
#..............#
#......||......#
#..............#
#..............#
#######..#######

#######..#######
#|............|#
#..............#
#..............#
#..............#
................
................
#..............#
#..............#
#..............#
#|............|#
#######..#######

#######..#######
#||||......||||#
#..............#
#..............#
#||||......||||#
................
................
#||||......||||#
#..............#
#..............#
#||||......||||#
#######..#######

#######..#######
#...|......|...#
#..............#
#|............|#
#..............#
................
................
#..............#
#|............|#
#..............#
#...|......|...#
#######..#######

#######..#######
#..............#
#........||....#
#.............|#
#..............#
.....|..........
....||..........
#..........|...#
#........|||...#
#..|.....|.....#
#.||...........#
#######..#######

#######..#######
#s............s#
#..............#
#|............|#
#|............|#
................
................
#|............|#
#|............|#
#..............#
#s............s#
#######..#######