#######..#######
#..............#
#..............#
#..............#
#..............#
................
................
#..............#
#..............#
#..............#
#..............#
#######..#######

#######..#######
#..............#
#..............#
#..............#
#..............#
................
.....||||||.....
#..............#
#..............#
#..............#
#..............#
#######..#######

#######..#######
#..............#
#..............#
#..............#
#..............#
................
................
#..............#
#..............#
#..............#
#..............#
#######..#######