#######..#######
#..............#
#..............#
#..............#
#..............#
................
................
#..............#
#..............#
#..............#
#..............#
#######..#######

#######..#######
#..............#
#..............#
#..............#
#..............#
................
................
#..............#
#..............#
#..............#
#..............#
#######..#######

#######..#######
#..............#
#..............#
#...||||||||...#
#..............#
......||||......
................
#......||......#
#..............#
#..|||....|||..#
#..............#
#######..#######

#######..#######
#..............#
#..............#
#...||....||...#
#.....|..|.....#
................
................
#.....|..|.....#
#...||....||...#
#..............#
#..............#
#######..#######

#######..#######
#...|......|...#
#...|||..|||...#
#..............#
#..............#
................
................
#..............#
#..............#
#...|||..|||...#
#...|......|...#
#######..#######

#######..#######
#..............#
#..............#
#|||||.......||#
#..............#
.......||.......
.......||@......
#..............#
#||.......|||||#
#..............#
#..............#
#######..#######

#######..#######
#|||||....|||||#
#||..........||#
#|............|#
#..............#
.......||.......
.......||@......
#..............#
#|............|#
#||..........||#
#|||||....|||||#
#######..#######

#######..#######
#..............#
#..............#
#..............#
#...|||...s|...#
....|....|||....
....|||...p|....
#...|....|||...#
#...|||...s|...#
#..............#
#..............#
#######..#######

#######..#######
#..............#
#.sss......sss.#
#..............#
#..............#
................
................
#..............#
#..............#
#.sss......sss.#
#..............#
#######..#######

#######..#######
#..............#
#...|......|...#
#...|......|...#
#......||......#
................
....|......|....
#..............#
#..............#
#...||....||...#
#..............#
#######..#######

#######..#######
#s............s#
#...|......|...#
#..|........|..#
#..............#
................
................
#..............#
#..|........|..#
#...|......|...#
#s............s#
#######..#######